1.COMPANY
(v)
establish=found: thành lập
run=operate=manage: điều hành---- operation(n): tổ chức---operater: người điều hành
machine: máy móc
expand: mở rộng --- expansion(n) sự mở rộng
acquire = buy: dành được, mua --- acquisition(n): sự dành được
invest in: đầu tư 
grow: lớn mạnh--- growth(n) sự lớn mạnh
went bankrupt: phá sản
(adj)
leading companies =  leader: người dẫn đầu
major companies: dẫn đầu
successful: thành công
profit: sinh lời

international: quốc tế = oversea = foreigner
naional: trong nước= domestic
(noun ghép)
company -policy:chính sách
	-sucess: thành công
	-assets: tài sản
	-cultures: văn hóa

2. SEMINAR= WORKSHOP= CONFERENCE= MEETING
(v)
hold = organize = conduct = carry out: tổ chức 
schedulea meetting: lên lịch
attend: tham dự --- attendee: người tham dự
		---attendent: tiếp viên, người phục vụ
train: --trainee: người đào tạo
	-trainer: người được đào tạo
mentee:người được hướng dẫn & mentor: cố vấn, người hướng dẫn
postpone = delay: trì hoãn
take place: diễn ra
(adj)
informative: giàu thông tin
economic: kinh tế --economical: tiết kiệm
frquently: thường xuyên
press conference: cuộc họp báo --press release (n) họp báo ra mắt (phim,nhac)
daily-weekly-monthly-quarterly- yearly=annual: hàng năm
urgent: khẩn cấp !!
board: cái bảng --the board of directors: cuộc họp của những người lảnh đạo	
stockholders = shareholders : cổ đông, cổ phần
(noun ghép)
conference --venue: địa điểm
	   --hall: hội trường
	   --chairman: chủ tọa
	   --guest: khách mời
	   --speakers: diễn giả
	   --agenda: chi tiết lịch trình( mấy giờ ăn, mấy giờ văn nghệ...)
	   --speech: bài diễn văn
metting --results: kết quả
	--minutes: biên bản

3.DEPARTMENT:phòng ban #khác nhau  APARTMENT: căn hộ
devide: phân chia
finance: tài chính

4. A CONTRACT = AN AGREEMENT: hợp đồng
(v)
signature(n): chữ ký
buy=acquire: mua, dành được
nagotiate: thương lượng ---nagotiation: sự thương lượng
renew: gia hạn --renewal(n): sự gia hạn
parties: bên A bên B
terminate: chấm dứt
immediately: ngay lập tức
(adj + contract)
long-term: dài hạn      + contract
important: quan trọng   + contract
lucrative: màu mỡ       + contract
draft: bản nháp	        + contract

5. 
(v)
search = look up = seek: tìm kiếm
attract = draw = appeal: cuốn hút, chú ý
serve: phục vụ
deal with = solve: giải quyết
customer = client = shopper = buyer = consumer: khách hàng
(adj)
loyal: trung thành
regular: thường xuyên
regular customer = patrons: khách hàng tiềm năg
potential: tiềm năng
(noun ghép)
customer --care: chăm sóc khách hàng
	 --support: hỗ trợ khách hàng
	 --requirements: yêu cầu
	 --demand: nhu cầu
	 --complains: phàn nàn
	 --records: hồ sơ
	 --satisfact: thỏa mãn 
	